00000000000000000000
01111111100011111110
01000000100010000010
01222200100010022210
01000000100010000010
01111111100011111110
00000000000000000000
00001111022201111000
00001000022200001000
00001111022201111000
00000000000000000000
01111110000000111110
01000000000000000010
01000222222222200010
0000000000B000000000