00000000000000000000
01111100000000011110
01000100022000010010
01000100022000010010
01000100000000010010
01111100000000011110
00000000000000000000
00001111000001111000
00001000000000001000
00001111000001111000
00000000000000000000
01111110000000111110
01000000000000000010
01000000222220000010
0000000000B000000000