00000000000000000000
01111100000000011110
01000000011111000010
01002222010001022210
01000000010001000010
01111100011111000110
00000000000000000000
00000000000000000000
01111110000000111110
01000010000000100010
01222210022220100010
01000010000000100010
01111110000000111110
00000000222220000000
0000000000B000000000