00000000000000000000
01111111100011111110
01000000000000000010
01222200011111000210
01000000010001000010
01111111110001111110
00000000000000000000
00001111000001111000
00001000000000001000
00001111000001111000
00000000000000000000
01111110022220111110
01000010020020100010
01000010222220100010
0000000000B000000000