00000000000000000000
01110022000011100000
01110022000011100000
01110000000011100000
01110000000000000000
00000011000000000000
00000011000111111110
02200011000000000010
02200000000000000010
00000000000011100010
00000000000011100010
01111110000011100000
01000000000000000000
01000000000022200000
000000000B0000000000